KEY

# = wall textureN
1 = wall brickwall


. = sector metalfloor metalroof
, = sector textureD textureU


MAP

#######################
#.....................#
#.....................#
#....P................#
#.....................#
#,,,,,,,,,,,###########
#,,,,,,,,,,,#
#,,,,,,,,,,,#
#,,,,,,,,,,,#
#,,,,,,,,,,,#
#,,,,,,,,,,,#
1111111111111
