KEY

# = wall textureN
1 = wall brickwall


. = sector metalfloor metalroof
, = sector textureD textureU


MAP

#################################1
#.......,,,,,,,,,,,,,,,,,,,,,,,,,1
#...P...,,,,,,,,,,,,,,,,,,,,,,,,,1
#.......,,,,,,,,,,,,,,,,,,,,,,,,,1
#.......,,,,,,,,,,,,,,,,,,,,,,,,,1
1111111111111111111111111111111111