KEY

# = wall textureN
1 = wall brickwall


. = sector metalfloor metalroof
, = sector textureD textureU


MAP

#######################
#.....................#
#.....................#
#....P................#
#.....................#
#,,,,,,,,##############
#,,,,,,,,##
#,,,,,,,,,##
#,,,,,,,,,,##
#,,,,,,,,,,,##
#,,,,,,,,,,,,##
#,,,,,,,,,,,11
#,,,,,,,,,,11
#,,,,,,,,,11
#,,,,,,,,11
1111111111
